# Other countries

AAA = "countries/Dummy.txt"
REB = "countries/Rebels.txt"
PIR = "countries/Pirates.txt"
NAT = "countries/Natives.txt"
# Cyrodiil

# Elswyer

ABL = "countries/Albaster.txt"
BRK = "countries/Bruk'ra.txt"
CRN = "countries/Corinth.txt"
HLK = "countries/Helkarn.txt"
DNE = "countries/Dune.txt"
OCR = "countries/Orcrest.txt"
RVH = "countries/Riverhold.txt"
RIM = "countries/TheRim.txt"
TVR = "countries/Torval.txt"
MST = "countries/Mistral.txt"
TEN = "countries/Tenmar.txt"
SEN = "countries/Senchal.txt"


#High Rock

DGF = "countries/Daggerfall.txt"
NMR = "countries/Northmoor.txt"
DAN = "countries/Daenia.txt"
URV = "countries/Urvaius.txt"
DWY = "countries/Dwynnen.txt"
PHY = "countries/Phrygias.txt"
BHO = "countries/Bhoraine.txt"

#Skyrim - NO FLAGS YET [ EMPTY BLACK FLAGS ]
DAL = "countries/Dale.txt"
DRB = "countries/DragonBridge.txt"
DHC = "countries/DreadhornClan.txt"
GRH = "countries/Granitehall.txt"
GWD = "countries/Greenwood.txt"
HEL = "countries/Helgen.txt"
IVA = "countries/Ivarstead.txt"
LKW = "countries/Karthwasten.txt"
ROR = "countries/Rorikstead.txt"
UKW = "countries/UpperKarth.txt"

#Skyrim - FLAGS

SKY = "countries/Skyrim.txt"
FAL = "countries/Falkreath.txt"
MOR = "countries/Hjaalmarch.txt"
MAR = "countries/Markarth.txt"
DNS = "countries/Pale.txt"
RFT = "countries/Rift.txt"
SOL = "countries/Solitude.txt"
WHR = "countries/Whiterun.txt"
WND = "countries/Windhelm.txt"
WNH = "countries/Winterhold.txt"
